* = goal
12345678901234567890123456789012345678901234
       # #    *   * #          #   #       #7
 ###*### #### * # * ###################### #8
 #  *  #    # *   *        #  *  #   #   # #9
 # * * # #  # ************ # *** # #   #   #0
 #* # *# #  #            * #  *  # #########1
 # * * # #  ###########  * #* * *# #  * * * 2
 #  *  # # ** * * * * **** #  *  # #        3
 #     # #                 ###*### #  * * * 4
 ### ### ###################  *  # ## * * * 5
     #   ######     #     ##  *  # ## * * * 6
###### #####    **** ****  #  *  # ## * * * 7
  #  #  #  # #      #      #     #    * * * 8
  #  #  #  # #  **** ***** # ###### ########9
  #  #  #  # ##     #     ##   ##   #       0
  #  #  #  # ################# ##***# * *** 1
***********  ####   #####       #   #   *   2
  #  #  #  ###### # ####  * * * # *## *## *#3
  #  #  #  #      # #    #*###* #   #   #   4
  #  #  #  #  *** # # # # *  #  ##* ##* ##* 5
  #  #  #  ###  **# # # # *  # ##   #   #   6
  #  #  #  ## ***   # # # #  # ## *## *## *#7
### #########       # # #   #*  #   #   #   8
              ##### # #   *     ##* #** ##* 9
 ##################   ######### #   *   ##  0
 # * * *        ##############  # *** *#    1
   # # #        ###       #### ##      #    2
 #****  #       ### ##### ####  # ##########3
  ****#  #      #   #   #    ## # #    #  ##4
 #****   #      #**** # ***  #  # # ****  ##5
  ****# #       ### *   *    # ## #       ##6
# # # #         ### ***** ## #    # ***** ##7